################################################################################
#...................................................................#..........#
###################################################################.#.########.#
#...........................................................#######.#.##    ##.#
#.#########################################################.#      .#.## ## ##.#
#.# #!....................................................#.#######.#.## ## ##.#
#.# #####################################################.#.........#.## #  ##.#
#.#                                                      .######### #.## ## ##.#
#.#######################################################.# #       #.## ## ##.#
#.#.......................................................  # ##### #.## ## ##.#
#.#.####################################################### # # ### #.## ## ##.#
#.#.#........#########################                      # #     #.## ## ##.#
#.#.#.######.........................######################## ##### #.## ## ##.#
#.#.#.## ### #######################.# ##     ###     ##    ##    # #.## ## ##.#
#.#.#..#     #                      .#    ###     ###    ##    #### #.## ## ##.#
#.#.##.#############################.# ############################ #.## ## ##.#
#.#.##.#.............           ###..#                            # #.## ## ##.#
#.#.##.#.###########.############...## ##############################.## ## ##.#
#.#....#...........#.#      ......####................................#  ###  .#
#.################.#.#######.#########.##############################   #### #.#
#........        #.#.#      ...........                           # ##########.#
########.#########.#.############################################## #..........#
#       ...........#..................................................### ######
################################################################################
